罗	罗丰
iph	iphone
hexx	hexa
草泥马	污泥
ixxx	iphonexx
natia	nativ
history	history
罗文浩	罗文干
nation	nation
ra	ra
genreic	genseric
清明上河	清明上河图
中共革命	闹革命
k	kA
hello	hello
hellp	help
abdcd	abdc
national	national
牛B	B
中国人民银行	中国人民银行
chat	chat
王上	以上
1+1=2	1+1=3
网达	亨达
王到	拣到
网上	网上
中国	中国
k	kA
heoo	hcoo
操你妈	操作
我是谁	一是理
histor	istor
sver	sver
王道	王道
xxxx	xxx
